0------------------0
|        - ----    |
|         - ----   |
|          - ----  |
|  LEVEL 1  - ---- |
|            - ----|
|             - ---|
|- ----            |
| - ----           |
0------------------0